season,team,rank,points,goals_for,goals_against,wins,draws,losses,goal_diff
2015,Leicester,1,81,68,36,23,12,3,32
2015,Arsenal,2,71,65,36,20,11,7,29
2015,Tottenham,3,70,69,35,19,13,6,34
2015,Manchester City,4,66,71,41,19,9,10,30
2015,Manchester United,5,66,49,35,19,9,10,14
2015,Southampton,6,63,59,41,18,9,11,18
2015,West Ham,7,62,65,51,16,14,8,14
2015,Liverpool,8,60,63,50,16,12,10,13
2015,Stoke City,9,51,41,55,14,9,15,-14
2015,Chelsea,10,50,59,53,12,14,12,6
2015,Everton,11,47,59,55,11,14,13,4
2015,Swansea,12,47,42,52,12,11,15,-10
2015,Watford,13,45,40,50,12,9,17,-10
2015,West Brom,14,43,34,48,10,13,15,-14
2015,Crystal Palace,15,42,39,51,11,9,18,-12
2015,Bournemouth,16,42,45,67,11,9,18,-22
2015,Sunderland,17,39,48,62,9,12,17,-14
2015,Newcastle,18,37,44,65,9,10,19,-21
2015,Norwich,19,34,39,67,9,7,22,-28
2015,Aston Villa,20,17,27,76,3,8,27,-49
2016,Chelsea,1,93,85,33,30,3,5,52
2016,Tottenham,2,86,86,26,26,8,4,60
2016,Manchester City,3,78,80,39,23,9,6,41
2016,Liverpool,4,76,78,42,22,10,6,36
2016,Arsenal,5,75,77,44,23,6,9,33
2016,Manchester United,6,69,54,29,18,15,5,25
2016,Everton,7,61,62,44,17,10,11,18
2016,Southampton,8,46,41,48,12,10,16,-7
2016,Bournemouth,9,46,55,67,12,10,16,-12
2016,West Brom,10,45,43,51,12,9,17,-8
2016,West Ham,11,45,47,64,12,9,17,-17
2016,Leicester,12,44,48,63,12,8,18,-15
2016,Stoke City,13,44,41,56,11,11,16,-15
2016,Crystal Palace,14,41,50,63,12,5,21,-13
2016,Swansea,15,41,45,70,12,5,21,-25
2016,Burnley,16,40,39,55,11,7,20,-16
2016,Watford,17,40,40,68,11,7,20,-28
2016,Hull City,18,34,37,80,9,7,22,-43
2016,Middlesbrough,19,28,27,53,5,13,20,-26
2016,Sunderland,20,24,29,69,6,6,26,-40
2017,Manchester City,1,100,106,27,32,4,2,79
2017,Manchester United,2,81,68,28,25,6,7,40
2017,Tottenham,3,77,74,36,23,8,7,38
2017,Liverpool,4,75,84,38,21,12,5,46
2017,Chelsea,5,70,62,38,21,7,10,24
2017,Arsenal,6,63,74,51,19,6,13,23
2017,Burnley,7,54,36,39,14,12,12,-3
2017,Everton,8,49,44,58,13,10,15,-14
2017,Leicester,9,47,56,60,12,11,15,-4
2017,Newcastle,10,44,39,47,12,8,18,-8
2017,Crystal Palace,11,44,45,55,11,11,16,-10
2017,Bournemouth,12,44,45,61,11,11,16,-16
2017,West Ham,13,42,48,68,10,12,16,-20
2017,Watford,14,41,44,64,11,8,19,-20
2017,Brighton,15,40,34,54,9,13,16,-20
2017,Huddersfield,16,37,28,58,9,10,19,-30
2017,Southampton,17,36,37,56,7,15,16,-19
2017,Swansea,18,33,28,56,8,9,21,-28
2017,Stoke City,19,33,35,68,7,12,19,-33
2017,West Brom,20,31,31,56,6,13,19,-25
2018,Manchester City,1,98,95,23,32,2,4,72
2018,Liverpool,2,97,89,22,30,7,1,67
2018,Chelsea,3,72,63,39,21,9,8,24
2018,Tottenham,4,71,67,39,23,2,13,28
2018,Arsenal,5,70,73,51,21,7,10,22
2018,Manchester United,6,66,65,54,19,9,10,11
2018,Wolves,7,57,47,46,16,9,13,1
2018,Everton,8,54,54,46,15,9,14,8
2018,Leicester,9,52,51,48,15,7,16,3
2018,West Ham,10,52,52,55,15,7,16,-3
2018,Watford,11,50,52,59,14,8,16,-7
2018,Crystal Palace,12,49,51,53,14,7,17,-2
2018,Newcastle,13,45,42,48,12,9,17,-6
2018,Bournemouth,14,45,56,70,13,6,19,-14
2018,Burnley,15,40,45,68,11,7,20,-23
2018,Southampton,16,39,45,65,9,12,17,-20
2018,Brighton,17,36,35,60,9,9,20,-25
2018,Cardiff,18,34,34,69,10,4,24,-35
2018,Fulham,19,26,34,81,7,5,26,-47
2018,Huddersfield,20,16,22,76,3,7,28,-54
2019,Liverpool,1,99,85,33,32,3,3,52
2019,Manchester City,2,81,102,35,26,3,9,67
2019,Manchester United,3,66,66,36,18,12,8,30
2019,Chelsea,4,66,69,54,20,6,12,15
2019,Leicester,5,62,67,41,18,8,12,26
2019,Tottenham,6,59,61,47,16,11,11,14
2019,Wolves,7,59,51,40,15,14,9,11
2019,Arsenal,8,56,56,48,14,14,10,8
2019,Sheffield Utd,9,54,39,39,14,12,12,0
2019,Burnley,10,54,43,50,15,9,14,-7
2019,Southampton,11,52,51,60,15,7,16,-9
2019,Everton,12,49,44,56,13,10,15,-12
2019,Newcastle,13,44,38,58,11,11,16,-20
2019,Crystal Palace,14,43,31,50,11,10,17,-19
2019,Brighton,15,41,39,54,9,14,15,-15
2019,West Ham,16,39,49,62,10,9,19,-13
2019,Aston Villa,17,35,41,67,9,8,21,-26
2019,Bournemouth,18,34,40,65,9,7,22,-25
2019,Watford,19,34,36,64,8,10,20,-28
2019,Norwich,20,21,26,75,5,6,27,-49
2020,Manchester City,1,86,83,32,27,5,6,51
2020,Manchester United,2,74,73,44,21,11,6,29
2020,Liverpool,3,69,68,42,20,9,9,26
2020,Chelsea,4,67,58,36,19,10,9,22
2020,Leicester,5,66,68,50,20,6,12,18
2020,West Ham,6,65,62,47,19,8,11,15
2020,Tottenham,7,62,68,45,18,8,12,23
2020,Arsenal,8,61,55,39,18,7,13,16
2020,Leeds,9,59,62,54,18,5,15,8
2020,Everton,10,59,47,48,17,8,13,-1
2020,Aston Villa,11,55,55,46,16,7,15,9
2020,Newcastle,12,45,46,62,12,9,17,-16
2020,Wolves,13,45,36,52,12,9,17,-16
2020,Crystal Palace,14,44,41,66,12,8,18,-25
2020,Southampton,15,43,47,68,12,7,19,-21
2020,Brighton,16,41,40,46,9,14,15,-6
2020,Burnley,17,39,33,55,10,9,19,-22
2020,Fulham,18,28,27,53,5,13,20,-26
2020,West Brom,19,26,35,76,5,11,22,-41
2020,Sheffield Utd,20,23,20,63,7,2,29,-43
2021,Manchester City,1,93,99,26,29,6,3,73
2021,Liverpool,2,92,94,26,28,8,2,68
2021,Chelsea,3,74,76,33,21,11,6,43
2021,Tottenham,4,71,69,40,22,5,11,29
2021,Arsenal,5,69,61,48,22,3,13,13
2021,Manchester United,6,58,57,57,16,10,12,0
2021,West Ham,7,56,60,51,16,8,14,9
2021,Leicester,8,52,62,59,14,10,14,3
2021,Brighton,9,51,42,44,12,15,11,-2
2021,Wolves,10,51,38,43,15,6,17,-5
2021,Newcastle,11,49,44,62,13,10,15,-18
2021,Crystal Palace,12,48,50,46,11,15,12,4
2021,Brentford,13,46,48,56,13,7,18,-8
2021,Aston Villa,14,45,52,54,13,6,19,-2
2021,Southampton,15,40,43,67,9,13,16,-24
2021,Everton,16,39,43,66,11,6,21,-23
2021,Leeds,17,38,42,79,9,11,18,-37
2021,Burnley,18,35,34,53,7,14,17,-19
2021,Watford,19,23,34,77,6,5,27,-43
2021,Norwich,20,22,23,84,5,7,26,-61
2022,Manchester City,1,89,94,33,28,5,5,61
2022,Arsenal,2,84,88,43,26,6,6,45
2022,Manchester United,3,75,58,43,23,6,9,15
2022,Newcastle,4,71,68,33,19,14,5,35
2022,Liverpool,5,67,75,47,19,10,9,28
2022,Brighton,6,62,72,53,18,8,12,19
2022,Aston Villa,7,61,51,46,18,7,13,5
2022,Tottenham,8,60,70,63,18,6,14,7
2022,Brentford,9,59,58,46,15,14,9,12
2022,Fulham,10,52,55,53,15,7,16,2
2022,Crystal Palace,11,45,40,49,11,12,15,-9
2022,Chelsea,12,44,38,47,11,11,16,-9
2022,Wolves,13,41,31,58,11,8,19,-27
2022,West Ham,14,40,42,55,11,7,20,-13
2022,Bournemouth,15,39,37,71,11,6,21,-34
2022,Nottingham Forest,16,38,38,68,9,11,18,-30
2022,Everton,17,36,34,57,8,12,18,-23
2022,Leicester,18,34,51,68,9,7,22,-17
2022,Leeds,19,31,48,78,7,10,21,-30
2022,Southampton,20,25,36,73,6,7,25,-37
2023,Manchester City,1,91,96,34,28,7,3,62
2023,Arsenal,2,89,91,29,28,5,5,62
2023,Liverpool,3,82,86,41,24,10,4,45
2023,Aston Villa,4,68,76,61,20,8,10,15
2023,Tottenham,5,66,74,61,20,6,12,13
2023,Chelsea,6,63,77,63,18,9,11,14
2023,Newcastle,7,60,85,62,18,6,14,23
2023,Manchester United,8,60,57,58,18,6,14,-1
2023,West Ham,9,52,60,74,14,10,14,-14
2023,Crystal Palace,10,49,57,58,13,10,15,-1
2023,Brighton,11,48,55,62,12,12,14,-7
2023,Bournemouth,12,48,54,67,13,9,16,-13
2023,Fulham,13,47,55,61,13,8,17,-6
2023,Wolves,14,46,50,65,13,7,18,-15
2023,Everton,15,40,40,51,13,9,16,-11
2023,Brentford,16,39,56,65,10,9,19,-9
2023,Nottingham Forest,17,32,49,67,9,9,20,-18
2023,Luton,18,26,52,85,6,8,24,-33
2023,Burnley,19,24,41,78,5,9,24,-37
2023,Sheffield Utd,20,16,35,104,3,7,28,-69
2024,Liverpool,1,84,86,41,25,9,4,45
2024,Arsenal,2,74,69,34,20,14,4,35
2024,Manchester City,3,71,72,44,21,8,9,28
2024,Chelsea,4,69,64,43,20,9,9,21
2024,Newcastle,5,66,68,47,20,6,12,21
2024,Aston Villa,6,66,58,51,19,9,10,7
2024,Nottingham Forest,7,65,58,46,19,8,11,12
2024,Brighton,8,61,66,59,16,13,9,7
2024,Bournemouth,9,56,58,46,15,11,12,12
2024,Brentford,10,56,66,57,16,8,14,9
2024,Fulham,11,54,54,54,15,9,14,0
2024,Crystal Palace,12,53,51,51,13,14,11,0
2024,Everton,13,48,42,44,11,15,12,-2
2024,West Ham,14,43,46,62,11,10,17,-16
2024,Manchester United,15,42,44,54,11,9,18,-10
2024,Wolves,16,42,54,69,12,6,20,-15
2024,Tottenham,17,38,64,65,11,5,22,-1
2024,Leicester,18,25,33,80,6,7,25,-47
2024,Ipswich,19,22,36,82,4,10,24,-46
2024,Southampton,20,12,26,86,2,6,30,-60
